vjdbv0.3_field_id	vjdbv0.3_name	vjdbv0.3_tags
insdc_accession_id	INSDC Accession ID	"[""NCBI Virus"", ""BV-BRC"", ""Organizational"", ""Identifiers""]"
assembly_accession_id	Assembly Accession ID	"[""NCBI Virus"", ""BV-BRC"", ""Organizational"", ""Identifiers""]"
bioproject_accession_id	Bioproject Accession ID	"[""ENA"", ""NCBI Virus"", ""BV-BRC"", ""Organizational"", ""Identifiers""]"
biosample_accession_id	Biosample Accession ID	"[""ENA"", ""MIGS-VI"", ""NCBI Virus"", ""BV-BRC"", ""Organizational"", ""Identifiers"", ""Sample""]"
collection_date	Collection Date	"[""ENA"", ""RKI"", ""MIGS-VI"", ""NCBI Virus"", ""BV-BRC"", ""ENA ERC32"", ""ENA ERC32"", ""ENA ERC33"", ""Sample"", ""Collection""]"
collection_country	Collection Country	"[""ENA"", ""MIGS-VI"", ""NCBI Virus"", ""BV-BRC"", ""ENA ERC32"", ""ENA ERC32"", ""ENA ERC33"", ""Sample""]"
sample_family	Sample Family	"[""NCBI Virus"", ""BV-BRC"", ""Sample"", ""Virus"", ""NCBI Taxonomy""]"
sequence_title	GenBank Title	"[""NCBI Virus"", ""Sample"", ""Sequence""]"
is_genbank_sequence	Is GenBank Sequence	"[""NCBI Virus"", ""Sample"", ""Sequence""]"
is_reference_sequence	Is Reference Sequence	"[""NCBI Virus"", ""BV-BRC"", ""Sample"", ""Sequence""]"
sample_variant	Sample Variant	"[""MIGS-VI"", ""NCBI Virus"", ""Sample"", ""Sequence"", ""Variation""]"
sample_genus	Sample Genus	"[""NCBI Virus"", ""BV-BRC"", ""Sample"", ""Virus"", ""NCBI Taxonomy""]"
collection_city	Collection City	"[""ENA"", ""NCBI Virus"", ""Sample""]"
collection_geo_location	Collection Geo Location	"[""NCBI Virus"", ""BV-BRC"", ""ENA ERC32"", ""ENA ERC32"", ""ENA ERC33"", ""Sample""]"
host_natural_common_name	Host Natural Common Name	"[""ENA"", ""NCBI Virus"", ""BV-BRC"", ""ENA ERC32"", ""ENA ERC32"", ""ENA ERC33"", ""Sample"", ""Host""]"
		[]
sample_isolate	Sample Isolate	"[""ENA"", ""NCBI Virus"", ""ENA ERC33"", ""Sample"", ""Virus""]"
sequence_length	Sequence Length	"[""NCBI Virus"", ""BV-BRC"", ""Sample"", ""Sequence""]"
molecule_type	Molecule Type	"[""ENA"", ""NCBI Virus"", ""Sample"", ""Virus""]"
sequence_completeness	Sequence Completeness	"[""NCBI Virus"", ""Sample"", ""Sequence""]"
organism_name	Organism Name	"[""NCBI Virus"", ""Sample"", ""Virus""]"
submitter_organization	Submitter Organization	"[""NCBI Virus"", ""Organizational"", ""Submission""]"
		"[""NCBI Virus"", ""Organizational""]"
sequence_repository_release_date	Sequence Repository Release Date	"[""RKI"", ""NCBI Virus"", ""Organizational""]"
		"[""Analysis""]"
sequence_segment_name	Sequence Segment Name	"[""NCBI Virus"", ""Sample"", ""Virus"", ""Sequence""]"
sample_NCBI_scientific_name [sample_species_name_scientific]	Sample NCBI Scientific Name	"[""ENA"", ""NCBI Virus"", ""BV-BRC"", ""Sample"", ""Virus"", ""NCBI Taxonomy""]"
sra_accession_id	SRA Accession ID	"[""NCBI Virus"", ""BV-BRC"", ""Organizational"", ""Identifiers""]"
submitter	Submitter	"[""NCBI Virus"", ""Organizational"", ""Submission""]"
collection_source_host_tissue	Collection Source Host Tissue	"[""ENA"", ""RKI"", ""MIGS-VI"", ""NCBI Virus"", ""ENA ERC32"", ""ENA ERC32"", ""ENA ERC33"", ""Sample"", ""Collection""]"
collection_region	Collection Region	"[""NCBI Virus"", ""Sample"", ""Collection""]"
analysis_accession_id	Analysis Accession ID	"[""ENA"", ""Organizational"", ""Identifiers"", ""Analysis""]"
assembly_description	Assembly Description	"[""ENA"", ""Analysis"", ""Sequence""]"
assembly_level	Assembly Level	"[""ENA"", ""Analysis"", ""Sequence""]"
assembly_min_gap_length	Assembly Min Gap Length	"[""ENA"", ""Analysis"", ""Sequence""]"
assembly_program	Assembly Program	"[""ENA"", ""MIGS-VI"", ""BV-BRC"", ""Analysis"", ""Sequence""]"
assembly_type	Assembly Type	"[""ENA"", ""Analysis"", ""Sequence""]"
bvbrc_accession_id	BVBRC Accession ID	"[""BV-BRC"", ""Organizational"", ""Identifiers"", ""Sequence""]"
collecting_institute	Collecting Institute	"[""ENA"", ""ENA ERC32"", ""ENA ERC32"", ""ENA ERC33"", ""Sample"", ""Collection""]"
collection_host_health_state	Collection Host Health State	"[""ENA"", ""ENA ERC32"", ""ENA ERC32"", ""ENA ERC33"", ""Sample"", ""Collection"", ""Host""]"
collection_location_latitude	Collection Location Latitude	"[""ENA"", ""MIGS-VI"", ""ENA ERC32"", ""ENA ERC32"", ""ENA ERC33"", ""Sample"", ""Collection""]"
collection_location_longitude	Collection Location Longitude	"[""ENA"", ""MIGS-VI"", ""ENA ERC32"", ""ENA ERC32"", ""ENA ERC33"", ""Sample"", ""Collection""]"
collection_region	Collection Region	"[""Sample"", ""Collection""]"
collection_source_environment	Collection Source Environment	"[""ENA"", ""MIGS-VI"", ""ENA ERC32"", ""ENA ERC32"", ""ENA ERC33"", ""Sample"", ""Collection""]"
collector_name	Collector Name	"[""ENA"", ""ENA ERC32"", ""ENA ERC32"", ""ENA ERC33"", ""Sample"", ""Collection""]"
cutoff_for_seropositive_sample	Cutoff for Seropositive Sample	"[""ENA"", ""ENA ERC32"", ""ENA ERC32"", ""ENA ERC33"", ""Sample"", ""Clinical""]"
experiment_accession_id	Experiment Accession ID	"[""ENA"", ""Organizational"", ""Identifiers"", ""Analysis""]"
host_age	Host Age	"[""ENA"", ""BV-BRC"", ""ENA ERC32"", ""ENA ERC32"", ""ENA ERC33"", ""Sample"", ""Clinical"", ""Host""]"
host_age_unit	Host Age Unit	"[""Sample"", ""Clinical"", ""Host""]"
host_behaviour	Host Behaviour	"[""ENA"", ""ENA ERC32"", ""ENA ERC32"", ""ENA ERC33"", ""Sample"", ""Clinical"", ""Host""]"
host_disease	Host Disease	"[""Sample"", ""Clinical"", ""Host""]"
host_disease_outcome	Host Disease Outcome	"[""ENA"", ""ENA ERC32"", ""ENA ERC32"", ""ENA ERC33"", ""Sample"", ""Clinical"", ""Host""]"
host_disease_symptoms	Host Disease Symptoms	"[""ENA"", ""Sample"", ""Clinical"", ""Host""]"
host_group	Host Group	"[""BV-BRC"", ""Sample"", ""Host"", ""Taxonomy""]"
host_habitat	Host Habitat	"[""ENA"", ""ENA ERC32"", ""ENA ERC32"", ""ENA ERC33"", ""Sample"", ""Host""]"
host_lab_common_name	Host Lab Common Name	"[""BV-BRC"", ""Sample"", ""Host""]"
host_lab_NCBI_tax_id	Host Lab NCBI Tax ID	"[""MIGS-VI"", ""Sample"", ""Host""]"
host_lab_scientific_name	Host Lab Scientific Name	"[""ENA"", ""MIGS-VI"", ""Sample"", ""Host""]"
host_natural_scientific_name	Host Natural Scientific Name	"[""ENA"", ""MIGS-VI"", ""BV-BRC"", ""ENA ERC32"", ""ENA ERC32"", ""ENA ERC33"", ""Sample"", ""Host""]"
host_NCBI_tax_id	Host NCBI Tax ID	"[""MIGS-VI"", ""ENA ERC33"", ""Sample"", ""Host"", ""NCBI Taxonomy""]"
host_sex	Host Sex	"[""ENA"", ""BV-BRC"", ""ENA ERC32"", ""ENA ERC32"", ""ENA ERC33"", ""Sample"", ""Clinical"", ""Host""]"
host_subject_id	Host Subject ID	"[""ENA"", ""ENA ERC32"", ""ENA ERC32"", ""ENA ERC33"", ""Sample"", ""Clinical "", ""Host""]"
influenza_test_method	Influenza Test Method	"[""ENA"", ""ENA ERC32"", ""ENA ERC32"", ""Sample"", ""Clinical "", ""Host""]"
influenza_test_result	Influenza Test Result	"[""ENA"", ""ENA ERC32"", ""ENA ERC32"", ""Sample"", ""Clinical "", ""Host""]"
influenza_virus_type	Influenza Virus Type	"[""ENA"", ""ENA ERC32"", ""ENA ERC32"", ""Sample"", ""Clinical "", ""Host""]"
is_BVBRC	is_BVBRC 	"[""Organizational"", ""Sequence""]"
other_pathogens_test_result	Other Pathogens Test Result	"[""ENA"", ""ENA ERC32"", ""ENA ERC32"", ""Sample"", ""Clinical "", ""Host""]"
other_pathogens_tested	Other Pathogens Tested	"[""ENA"", ""ENA ERC32"", ""ENA ERC32"", ""Sample"", ""Clinical "", ""Host""]"
pangolin_lineage	Pangolin Lineage	"[""RKI"", ""BV-BRC"", ""Analysis"", ""Sequence""]"
pangolin_version	Pangolin Version	"[""RKI"", ""Analysis"", ""Sequence""]"
receipt_date	Receipt Date	"[""ENA"", ""ENA ERC32"", ""ENA ERC32"", ""ENA ERC33"", ""Sample""]"
rki_sequence_id	RKI Sequence ID	"[""RKI"", ""Organizational"", ""Identifiers""]"
run_accession_id	Run Accession ID	"[""ENA"", ""Organizational"", ""Identifiers""]"
sample_ictv_scientific_name	Sample Ictv Scientific Name	"[""Sample"", ""Virus"", ""ICTV Taxonomy""]"
sample_NCBI_tax_id	Sample NCBI Tax ID	"[""ENA"", ""MIGS-VI"", ""BV-BRC"", ""ENA ERC32"", ""ENA ERC32"", ""ENA ERC33"", ""Sample"", ""Virus "", ""NCBI Taxonomy""]"
sample_serotype	Sample Serotype	"[""ENA"", ""MIGS-VI"", ""ENA ERC32"", ""ENA ERC32"", ""ENA ERC33"", ""Sample"", ""Clinical""]"
sample_species_name_abbreviation	Sample Species Name Abbreviation	"[""Sample"", ""Virus""]"
sample_species_tax_id	Sample Species Tax ID	"[""Sample"", ""Virus"", ""NCBI Taxonomy""]"
sequence_average_depth_coverage	Sequence Average Depth Coverage	"[""ENA"", ""BV-BRC"", ""Analysis"", ""Sequence""]"
sequence_gc_content	Sequence GC Content	"[""BV-BRC"", ""Analysis"", ""Sequence""]"
sequence_length_coverage	Sequence Length Coverage	"[""MIGS-VI"", ""Analysis"", ""Sequence""]"
sequence_name	Sequence Name	"[""MIGS-VI"", ""BV-BRC"", ""Analysis"", ""Sequence""]"
sequence_number_of_contigs	Sequence Number of Contigs	"[""MIGS-VI"", ""Analysis"", ""Sequence""]"
sequence_publication_doi	Sequence Publication DOI	"[""MIGS-VI"", ""Organizational""]"
sequence_pubmed_id	Sequence Pubmed ID	"[""MIGS-VI"", ""BV-BRC"", ""Organizational"", ""Identifiers""]"
sequence_update_date	Sequence Update Date	"[""BV-BRC"", ""Organizational"", ""Sequence""]"
sequence_version	Sequence Version	"[""RKI"", ""Organizational"", ""Sequence""]"
sequencing_center	Sequencing Center	"[""BV-BRC"", ""Organizational"", ""Sequence""]"
sequencing_insert_size	Sequencing Insert Size	"[""ENA"", ""ENA ERC32"", ""ENA ERC32"", ""ENA ERC33"", ""Analysis"", ""Sequencing""]"
sequencing_instrument	Sequencing Instrument	"[""ENA"", ""MIGS-VI"", ""ENA ERC32"", ""ENA ERC32"", ""ENA ERC33"", ""Analysis"", ""Sequencing""]"
sequencing_library_construction_protocol	Sequencing Library Construction Protocol	"[""ENA"", ""ENA ERC32"", ""ENA ERC32"", ""ENA ERC33"", ""Analysis"", ""Sequencing""]"
sequencing_library_description	Sequencing Library Description	"[""ENA"", ""ENA ERC32"", ""ENA ERC32"", ""ENA ERC33"", ""Analysis"", ""Sequencing""]"
sequencing_library_layout	Sequencing Library Layout	"[""ENA"", ""MIGS-VI"", ""ENA ERC32"", ""ENA ERC32"", ""ENA ERC33"", ""Analysis"", ""Sequencing""]"
sequencing_library_name	Sequencing Library Name	"[""ENA"", ""ENA ERC32"", ""ENA ERC32"", ""ENA ERC33"", ""Analysis"", ""Sequencing""]"
sequencing_library_selection	Sequencing Library Selection	"[""ENA"", ""MIGS-VI"", ""ENA ERC32"", ""ENA ERC32"", ""ENA ERC33"", ""Analysis"", ""Sequencing""]"
sequencing_library_source	Sequencing Library Source	"[""ENA"", ""ENA ERC32"", ""ENA ERC32"", ""ENA ERC33"", ""Analysis"", ""Sequencing""]"
sequencing_library_strategy	Sequencing Library Strategy	"[""ENA"", ""ENA ERC32"", ""ENA ERC32"", ""ENA ERC33"", ""Analysis"", ""Sequencing""]"
sequencing_platform	Sequencing Platform	"[""ENA"", ""RKI"", ""BV-BRC"", ""ENA ERC32"", ""ENA ERC32"", ""ENA ERC33"", ""Analysis"", ""Sequencing""]"
sequencing_reason	Sequencing Reason	"[""ENA"", ""RKI"", ""Analysis"", ""Sequencing""]"
source_metadata_db	Source Metadata DB	"[""Organizational"", ""Source""]"
submitter_country	Submitter Country	"[""NCBI Virus"", ""Sample"", ""Submission""]"
submitter_region	Submitter Region	"[""Sample"", ""Submission""]"
taxon_lineage_ids	Taxon Lineage IDs	"[""BV-BRC"", ""Organizational"", ""Submission""]"
virjen_id	VirJen ID	"[""Organizational"", ""Sequence""]"
virus_id	Virus ID	"[""ENA"", ""RKI"", ""ENA ERC32"", ""ENA ERC32"", ""ENA ERC33"", ""Organizational"", ""Virus""]"
